"filename", "language", "C++", "ABC", "TypeScript", "Python", "JavaScript", "comment", "blank", "total"
"/Users/AppleBird/Documents/programming/VSCodeProject/siv3d_v0.6.13_macOS/examples/GraziePianoTuner4/src/ABCParser.cpp", "C++", 85, 0, 0, 0, 0, 18, 14, 117
"/Users/AppleBird/Documents/programming/VSCodeProject/siv3d_v0.6.13_macOS/examples/GraziePianoTuner4/src/ABCParser.hpp", "C++", 30, 0, 0, 0, 0, 5, 1, 36
"/Users/AppleBird/Documents/programming/VSCodeProject/siv3d_v0.6.13_macOS/examples/GraziePianoTuner4/src/Basics.hpp", "C++", 69, 0, 0, 0, 0, 1, 4, 74
"/Users/AppleBird/Documents/programming/VSCodeProject/siv3d_v0.6.13_macOS/examples/GraziePianoTuner4/src/Composed.cpp", "C++", 25, 0, 0, 0, 0, 0, 3, 28
"/Users/AppleBird/Documents/programming/VSCodeProject/siv3d_v0.6.13_macOS/examples/GraziePianoTuner4/src/Composed.hpp", "C++", 60, 0, 0, 0, 0, 1, 4, 65
"/Users/AppleBird/Documents/programming/VSCodeProject/siv3d_v0.6.13_macOS/examples/GraziePianoTuner4/src/ComposedRenderer.cpp", "C++", 198, 0, 0, 0, 0, 7, 26, 231
"/Users/AppleBird/Documents/programming/VSCodeProject/siv3d_v0.6.13_macOS/examples/GraziePianoTuner4/src/ComposedRenderer.hpp", "C++", 75, 0, 0, 0, 0, 15, 11, 101
"/Users/AppleBird/Documents/programming/VSCodeProject/siv3d_v0.6.13_macOS/examples/GraziePianoTuner4/src/Concepts.hpp", "C++", 19, 0, 0, 0, 0, 4, 5, 28
"/Users/AppleBird/Documents/programming/VSCodeProject/siv3d_v0.6.13_macOS/examples/GraziePianoTuner4/src/DebugTools.hpp", "C++", 5, 0, 0, 0, 0, 0, 1, 6
"/Users/AppleBird/Documents/programming/VSCodeProject/siv3d_v0.6.13_macOS/examples/GraziePianoTuner4/src/EditRoom.cpp", "C++", 127, 0, 0, 0, 0, 23, 11, 161
"/Users/AppleBird/Documents/programming/VSCodeProject/siv3d_v0.6.13_macOS/examples/GraziePianoTuner4/src/EditRoom.hpp", "C++", 49, 0, 0, 0, 0, 10, 6, 65
"/Users/AppleBird/Documents/programming/VSCodeProject/siv3d_v0.6.13_macOS/examples/GraziePianoTuner4/src/EmotionalController.cpp", "C++", 125, 0, 0, 0, 0, 3, 17, 145
"/Users/AppleBird/Documents/programming/VSCodeProject/siv3d_v0.6.13_macOS/examples/GraziePianoTuner4/src/EmotionalController.hpp", "C++", 70, 0, 0, 0, 0, 5, 14, 89
"/Users/AppleBird/Documents/programming/VSCodeProject/siv3d_v0.6.13_macOS/examples/GraziePianoTuner4/src/HarmonicGuide.cpp", "C++", 201, 0, 0, 0, 0, 5, 22, 228
"/Users/AppleBird/Documents/programming/VSCodeProject/siv3d_v0.6.13_macOS/examples/GraziePianoTuner4/src/HarmonicGuide.hpp", "C++", 82, 0, 0, 0, 0, 5, 15, 102
"/Users/AppleBird/Documents/programming/VSCodeProject/siv3d_v0.6.13_macOS/examples/GraziePianoTuner4/src/HistoryViewer.cpp", "C++", 47, 0, 0, 0, 0, 0, 2, 49
"/Users/AppleBird/Documents/programming/VSCodeProject/siv3d_v0.6.13_macOS/examples/GraziePianoTuner4/src/HistoryViewer.hpp", "C++", 115, 0, 0, 0, 0, 5, 14, 134
"/Users/AppleBird/Documents/programming/VSCodeProject/siv3d_v0.6.13_macOS/examples/GraziePianoTuner4/src/Interface/PanelComponents.hpp", "C++", 30, 0, 0, 0, 0, 12, 13, 55
"/Users/AppleBird/Documents/programming/VSCodeProject/siv3d_v0.6.13_macOS/examples/GraziePianoTuner4/src/LLMAgents.hpp", "C++", 77, 0, 0, 0, 0, 0, 4, 81
"/Users/AppleBird/Documents/programming/VSCodeProject/siv3d_v0.6.13_macOS/examples/GraziePianoTuner4/src/Layout.cpp", "C++", 35, 0, 0, 0, 0, 12, 4, 51
"/Users/AppleBird/Documents/programming/VSCodeProject/siv3d_v0.6.13_macOS/examples/GraziePianoTuner4/src/Layout.hpp", "C++", 59, 0, 0, 0, 0, 12, 3, 74
"/Users/AppleBird/Documents/programming/VSCodeProject/siv3d_v0.6.13_macOS/examples/GraziePianoTuner4/src/Main.cpp", "C++", 28, 0, 0, 0, 0, 15, 9, 52
"/Users/AppleBird/Documents/programming/VSCodeProject/siv3d_v0.6.13_macOS/examples/GraziePianoTuner4/src/MainApp.hpp", "C++", 136, 0, 0, 0, 0, 9, 22, 167
"/Users/AppleBird/Documents/programming/VSCodeProject/siv3d_v0.6.13_macOS/examples/GraziePianoTuner4/src/Main_test.cpp", "C++", 26, 0, 0, 0, 0, 1, 5, 32
"/Users/AppleBird/Documents/programming/VSCodeProject/siv3d_v0.6.13_macOS/examples/GraziePianoTuner4/src/Main_test.hpp", "C++", 2, 0, 0, 0, 0, 0, 1, 3
"/Users/AppleBird/Documents/programming/VSCodeProject/siv3d_v0.6.13_macOS/examples/GraziePianoTuner4/src/Music.cpp", "C++", 85, 0, 0, 0, 0, 10, 10, 105
"/Users/AppleBird/Documents/programming/VSCodeProject/siv3d_v0.6.13_macOS/examples/GraziePianoTuner4/src/Music.hpp", "C++", 65, 0, 0, 0, 0, 20, 5, 90
"/Users/AppleBird/Documents/programming/VSCodeProject/siv3d_v0.6.13_macOS/examples/GraziePianoTuner4/src/MusicalGPT4.cpp", "C++", 86, 0, 0, 0, 0, 4, 12, 102
"/Users/AppleBird/Documents/programming/VSCodeProject/siv3d_v0.6.13_macOS/examples/GraziePianoTuner4/src/MusicalGPT4.hpp", "C++", 34, 0, 0, 0, 0, 7, 10, 51
"/Users/AppleBird/Documents/programming/VSCodeProject/siv3d_v0.6.13_macOS/examples/GraziePianoTuner4/src/NoteOccuranceEffect.cpp", "C++", 24, 0, 0, 0, 0, 0, 2, 26
"/Users/AppleBird/Documents/programming/VSCodeProject/siv3d_v0.6.13_macOS/examples/GraziePianoTuner4/src/NoteOccuranceEffect.hpp", "C++", 19, 0, 0, 0, 0, 0, 3, 22
"/Users/AppleBird/Documents/programming/VSCodeProject/siv3d_v0.6.13_macOS/examples/GraziePianoTuner4/src/PianoRenderer.hpp", "C++", 61, 0, 0, 0, 0, 5, 5, 71
"/Users/AppleBird/Documents/programming/VSCodeProject/siv3d_v0.6.13_macOS/examples/GraziePianoTuner4/src/RichButton.hpp", "C++", 75, 0, 0, 0, 0, 0, 6, 81
"/Users/AppleBird/Documents/programming/VSCodeProject/siv3d_v0.6.13_macOS/examples/GraziePianoTuner4/src/SideMenuButtons.hpp", "C++", 45, 0, 0, 0, 0, 1, 1, 47
"/Users/AppleBird/Documents/programming/VSCodeProject/siv3d_v0.6.13_macOS/examples/GraziePianoTuner4/src/index.js", "JavaScript", 0, 0, 0, 0, 93, 5, 1, 99
"/Users/AppleBird/Documents/programming/VSCodeProject/siv3d_v0.6.13_macOS/examples/GraziePianoTuner4/src/index.ts", "TypeScript", 0, 0, 72, 0, 0, 5, 12, 89
"/Users/AppleBird/Documents/programming/VSCodeProject/siv3d_v0.6.13_macOS/examples/GraziePianoTuner4/src/midifile/Binasc.cpp", "C++", 1440, 0, 0, 0, 0, 281, 292, 2013
"/Users/AppleBird/Documents/programming/VSCodeProject/siv3d_v0.6.13_macOS/examples/GraziePianoTuner4/src/midifile/MidiEvent.cpp", "C++", 156, 0, 0, 0, 0, 71, 73, 300
"/Users/AppleBird/Documents/programming/VSCodeProject/siv3d_v0.6.13_macOS/examples/GraziePianoTuner4/src/midifile/MidiEventList.cpp", "C++", 272, 0, 0, 0, 0, 228, 125, 625
"/Users/AppleBird/Documents/programming/VSCodeProject/siv3d_v0.6.13_macOS/examples/GraziePianoTuner4/src/midifile/MidiFile.cpp", "C++", 1921, 0, 0, 0, 0, 852, 667, 3440
"/Users/AppleBird/Documents/programming/VSCodeProject/siv3d_v0.6.13_macOS/examples/GraziePianoTuner4/src/midifile/MidiMessage.cpp", "C++", 1167, 0, 0, 0, 0, 636, 501, 2304
"/Users/AppleBird/Documents/programming/VSCodeProject/siv3d_v0.6.13_macOS/examples/GraziePianoTuner4/src/midifile/Options.cpp", "C++", 607, 0, 0, 0, 0, 308, 305, 1220
"/Users/AppleBird/Documents/programming/VSCodeProject/siv3d_v0.6.13_macOS/examples/GraziePianoTuner4/src/sandbox/abc_to_midi.py", "Python", 0, 0, 0, 3, 0, 0, 2, 5
"/Users/AppleBird/Documents/programming/VSCodeProject/siv3d_v0.6.13_macOS/examples/GraziePianoTuner4/src/sandbox/example.abc", "ABC", 0, 10, 0, 0, 0, 0, 1, 11
"/Users/AppleBird/Documents/programming/VSCodeProject/siv3d_v0.6.13_macOS/examples/GraziePianoTuner4/src/sandbox/prompting_tester.py", "Python", 0, 0, 0, 35, 0, 0, 11, 46
"/Users/AppleBird/Documents/programming/VSCodeProject/siv3d_v0.6.13_macOS/examples/GraziePianoTuner4/src/test.abc", "ABC", 0, 14, 0, 0, 0, 0, 0, 14
"/Users/AppleBird/Documents/programming/VSCodeProject/siv3d_v0.6.13_macOS/examples/GraziePianoTuner4/src/util.cpp", "C++", 35, 0, 0, 0, 0, 0, 5, 40
"/Users/AppleBird/Documents/programming/VSCodeProject/siv3d_v0.6.13_macOS/examples/GraziePianoTuner4/src/util.hpp", "C++", 21, 0, 0, 0, 0, 0, 5, 26
"Total", "-", 7888, 24, 72, 38, 93, 2601, 2285, 13001